{
	"height": 15,
	"width": 48,
    "viewHeight": null,
    "viewWidth": null,
    "mapScale": 3,
    "scripts": {
        "tick": null,
        "load": null,
        "death": null
    },
    "levelPadding": {
        "top": 0,
        "right": 1,
        "bottom": 1,
        "left": 1,
        "with": 2
    },
	"tilesheets": {
        "1": "puzzlegame:images/green_tiles",
        "2": "puzzlegame:images/pink_tiles",
        "3": "puzzlegame:images/white_tiles"
    },
    "tilesheetSettings": {
        "1": {
            "connectsTo": [1, 2]
        },
        "2": {
            "connectsTo": [1, 2]
        }
    },
	"level": [
        2,2,2,2,2,0,0,0,0,0,0,0,0,0,0,0,0,0,0,0,0,0,0,0,2,2,2,2,2,0,0,0,0,0,0,0,0,0,0,0,0,0,0,0,0,0,0,0,
        2,1,1,1,2,1,0,1,1,1,0,1,0,1,1,1,0,0,0,1,0,1,0,0,2,1,1,1,2,1,0,1,1,1,0,1,0,1,1,1,0,0,0,1,0,1,0,0,
        2,1,2,1,2,1,0,0,0,0,0,1,1,0,1,0,1,0,1,1,0,1,1,0,2,1,2,1,2,1,0,0,0,0,0,1,1,0,1,0,1,0,1,1,0,1,1,0,
        2,1,1,1,2,1,0,0,1,0,0,1,0,0,0,1,1,1,0,1,0,0,0,0,2,1,1,1,2,1,0,0,1,0,0,1,0,0,0,1,1,1,0,1,0,0,0,0,
        2,2,2,2,2,0,0,0,0,0,0,0,0,0,0,0,0,0,0,0,0,0,0,0,2,2,2,2,2,0,0,0,0,0,0,0,0,0,0,0,0,0,0,0,0,0,0,0,
        2,2,2,2,2,0,0,0,0,0,0,0,0,0,0,0,0,0,0,0,0,0,0,0,2,2,2,2,2,0,0,0,0,0,0,0,0,0,0,0,0,0,0,0,0,0,0,0,
        2,1,1,1,2,1,0,1,1,1,0,1,0,1,1,1,0,0,0,1,0,1,0,0,2,1,1,1,2,1,0,1,1,1,0,1,0,1,1,1,0,0,0,1,0,1,0,0,
        2,1,2,1,2,1,0,0,0,0,0,1,1,0,1,0,1,0,1,1,0,1,1,0,0,0,0,0,0,0,0,0,0,0,0,1,1,0,1,0,1,0,1,1,0,1,1,0,
        2,1,1,1,2,1,0,0,1,0,0,1,0,0,0,1,1,1,0,1,0,0,0,0,2,1,1,1,2,1,0,0,1,0,0,1,0,0,0,1,1,1,0,1,0,0,0,0,
        2,2,2,2,2,0,0,0,0,0,0,0,0,0,0,0,0,0,0,0,0,0,0,0,2,2,2,2,2,0,0,0,0,0,0,0,0,0,0,0,0,0,0,0,0,0,0,0,
        2,2,2,2,2,0,0,0,0,0,0,0,0,0,0,0,0,0,0,0,0,0,0,0,2,2,2,2,2,0,0,0,3,3,3,3,3,3,3,3,3,3,3,3,3,3,0,0,
        2,1,1,1,2,1,0,1,1,1,0,1,0,1,1,1,0,0,0,1,0,1,0,0,2,1,1,1,2,1,0,1,1,1,0,1,0,1,1,1,0,0,0,1,0,1,0,0,
        2,1,2,1,2,1,0,0,0,0,0,1,1,0,1,0,1,0,1,1,0,1,1,0,2,1,2,1,2,1,0,0,0,0,0,1,1,0,1,0,1,0,1,1,0,1,1,0,
        2,1,1,1,2,1,0,0,1,0,0,1,0,0,0,1,1,1,0,1,0,0,0,0,2,1,1,1,2,1,0,0,1,0,0,1,0,0,0,1,1,1,0,1,0,0,0,0,
        2,2,2,2,2,0,0,0,0,0,0,0,0,0,0,0,0,0,0,0,0,0,0,0,2,2,2,2,2,0,0,0,0,0,0,0,0,0,0,0,0,0,0,0,0,0,0,0
    ],
    "objects": {
        "player": {"x": 8, "y": 0, "type": "platformer"},
        "spawnpoints": {
            "test": {"x": 14, "y": 0}
        },
        "loadingZones": [
            {
                "load": "%menu",
                "position": {
                    "x": 0,
                    "y": 0,
                    "width": 1,
                    "height": 1
                },
                "sprite": "%color:0xaaffff00"
            }
        ],
        "other": [

        ]
    }
}